*************************************************
**************************   ********************
********************* S** **  **F****************
******************          *  *  ***************
****************   *********   ** ***************
**************   *************  * ***************
*************  ****************   ***************
************  ******************* ***************
************ ********************  **************
************ ********************* **************
***********  ********************* **************
*********** **********************  *************
**********  **********************  *************
***********      ****      ******* **************
*********   ****  **  ****  ****** **************
********* *******    ******  ***** **************
********   *******  ********  ***  **************
******** *********  ********* **  ***************
******** ********* *** ****** *    **************
********  ******** ********** *    **************
*********  *******  ********      ***************
**********        *  ****** ** * ****************
*********    *******       **  * ****************
******** * * **************** *   ***************
********   *          **********   **************
*********   **           ****** *  **************
*********  ************   ***** * ***************
********* ***************  ***    ***************
********* ** * * * *******  **  *****************
********* * * * *** * * *** *** *****************
********  **** * * *** ****  *  *****************
******** ******** * * * ***  ** *****************
********     * *** * ****** *** *****************
*********       *** * * **  *** *****************
************    ********** ****   ***************
***************  *******   **** * ***************
***************          ***    *  **************
************* ****     ***   ***** **************
************ ** *******    ******* **************
*********** **  *****   *********   *************
*********** **  ****   *********  *  ************
********   *    **** **********  ***        *****
******* **   **  **  ** ******  **** ******  ****
***** ****  **** ** *** *****  ****  *******  ***
**** *********** *  *** **    ****  *********  **
*** ****** *****   ****    ******  ***********  *
*** ***** ******* *************** ************* *
** ***** ***********************  ***************
** ***** *********************** ****************
*************************************************
