*************************************************
*************************************************
*************************************************
************************S************************
*******************      *F    ******************
****************   * * *******    ***************
**************    *         * ***   *************
*************  *                 **   ***********
************  *    **    *         **  **********
**********   *      *   ***      **     *********
**********          **         **     *   *******
***************       **     **     *****  ******
*****************       ** **      ******* ******
******************        *  *   *********  *****
******* ************         * ************ *****
******      ********** *    * **********     ****
******  **    ********  *  * ********        ****
*****  ***      *******  *   ******    * ***  ***
*****  ** *       ****** *  ******     * ***  ***
****   ** *     ******** *  ********   *  **  ***
****   ** *    ** *******  ******* ** * * **   **
****  ** * *** **  ******  ******  **  *   *   **
****  **  * *  **********  ********** *** ***  **
****  *** **** ********* *  ********* **  ***  **
**** ****  ***  *******      *******  ** ****  **
**** ***** ***   ******       *****  *   ***** **
****  ****  * *    **               *** *****  **
****  ** **   ** *     *     *     * * ***** * **
****  *******     * * ********* * *   ** ****  **
**** ***** *****   * * * *** ***  ****** ***   **
****  ** **   *******   *** *  ******* **** * ***
*****  ***** * * ********* ***** **  * ****** ***
*****  **  *** *  *  **********   *  * * **   ***
****** ** * ** *  *  *   **   *   *  *** **  ****
******  ***  ***  *  *        ** ** *** ***  ****
******   ** *  ***** *    *    * ****   **  *****
*******   *** * ** ****   *   **** ** ***  ******
********   **** *  * **********   * ***   *******
*********   ****  *     *       * * *** *********
**********    *****  *        * ******  *********
*********** *    ***** ** ** ********** *********
************  **   **************  ** ***********
**************** *               **  ************
**************** *******      **** **************
******************  ****** ****  ****************
*************************************************
*************************************************
*************************************************
*************************************************
*************************************************